12 19
BBBBBBCBBBBB
CBBCBBBBBBBC
BBBBBBBBCBBC
BBCBBCBBBBBB
BBBCBBBBCBBB
BBCBCBBBCBBB
BBCBBCBCBBBB
BBBCBCCBCBBC
BBBCCBCCCCBB
BBBCCCBBBBBC
BBBBCBBBCCCC
BCBCBBCBCBBC
BBBBBBBCBBBB
BBBBBBBBBCBB
CBBCBBBBCBBC
BCCCCCBCBCCC
BCCBBBBBBCCB
BCCCBBCCBBCC
BCBBBBBCCBBC
