9 16
BBCBBBBBB
BCBBBBBBB
BCBCBBCBB
BBBCBBCBB
BCCBBCBBB
CBBCBBCBB
BBBBBBCCB
BBBCCCCBC
BBBBBBBBB
BCBBBBBBB
BCBCBBCBB
BBBCBBCBB
BCCBBCBBB
CBBCBBCBB
BBBBBBCCB
BBBCCCCBC

