16 27
BBBBBBCCBCBBBBCC
BBBCCCBBBBCBCCCB
BBBCBBCBCBBCBBCB
BBCBCBBBBBBBBBBB
BBBBBBBBBBBBBCBB
BBBBBCCCBBBBBBBC
BCBBBCCCCCBCBBCB
CBCBCCBBCBBBBBBB
BBBBBCBCBCBBCBBB
BBBBCBBBCBCCBCBB
BBBCCCBCBBCBCCBB
CCCBCCBBBCBBBCBB
BCBCBBCBCBBCBBCB
BBBBBCBBCBCCBCCB
CBCBBBCBBCBBBBCB
BBBBCCBBBBBBCBCC
BCBBBBBBBCCBBBBB
CBBCCCBBCBCBCBCB
CBBBBBCBBBBBCBBB
BBBBCBBBBCBBCBBC
BBBBBCBBBBCBCBBB
CBCBCCBCCBCBCBBB
BCBCBBBBBBBBBBBB
BBBBBBCBCCCBBBCB
BCCBCCBBBBCBBBBB
BBBBBCBBBBCBBCBB
BCBCCBBBBBBBCCCB
